"날짜","일차","출발시간","소요시간","눈비","교통량합계1종","교통량합계2종","인구수","교통량합계"
2013-02-08,0,0,91,TRUE,11369763,523201,10388055,11892964
2013-02-09,1,0,132,TRUE,11369763,523201,10388055,11892964
2013-02-10,2,0,83,TRUE,11369763,523201,10388055,11892964
2013-02-11,3,0,87,TRUE,11369763,523201,10388055,11892964
2013-02-12,4,0,84,TRUE,11369763,523201,10388055,11892964
2013-02-08,0,1,88,TRUE,7518962,470000,10388055,7988962
2013-02-09,1,1,129,TRUE,7518962,470000,10388055,7988962
2013-02-10,2,1,82,TRUE,7518962,470000,10388055,7988962
2013-02-11,3,1,85,FALSE,7518962,470000,10388055,7988962
2013-02-12,4,1,82,FALSE,7518962,470000,10388055,7988962
2013-02-08,0,2,88,TRUE,5250235,496078,10388055,5746313
2013-02-09,1,2,121,TRUE,5250235,496078,10388055,5746313
2013-02-10,2,2,102,TRUE,5250235,496078,10388055,5746313
2013-02-11,3,2,89,FALSE,5250235,496078,10388055,5746313
2013-02-12,4,2,78,FALSE,5250235,496078,10388055,5746313
2013-02-08,0,3,87,TRUE,4230974,624683,10388055,4855657
2013-02-09,1,3,124,TRUE,4230974,624683,10388055,4855657
2013-02-10,2,3,100,TRUE,4230974,624683,10388055,4855657
2013-02-11,3,3,84,TRUE,4230974,624683,10388055,4855657
2013-02-12,4,3,79,TRUE,4230974,624683,10388055,4855657
2013-02-08,0,4,91,TRUE,4975804,874748,10388055,5850552
2013-02-09,1,4,119,TRUE,4975804,874748,10388055,5850552
2013-02-10,2,4,93,TRUE,4975804,874748,10388055,5850552
2013-02-11,3,4,85,TRUE,4975804,874748,10388055,5850552
2013-02-12,4,4,84,TRUE,4975804,874748,10388055,5850552
2013-02-08,0,5,97,TRUE,10667595,1498576,10388055,12166171
2013-02-09,1,5,118,TRUE,10667595,1498576,10388055,12166171
2013-02-10,2,5,106,TRUE,10667595,1498576,10388055,12166171
2013-02-11,3,5,81,TRUE,10667595,1498576,10388055,12166171
2013-02-12,4,5,79,TRUE,10667595,1498576,10388055,12166171
2013-02-08,0,6,96,TRUE,23601930,2654556,10388055,26256486
2013-02-09,1,6,128,TRUE,23601930,2654556,10388055,26256486
2013-02-10,2,6,100,TRUE,23601930,2654556,10388055,26256486
2013-02-11,3,6,81,TRUE,23601930,2654556,10388055,26256486
2013-02-12,4,6,80,TRUE,23601930,2654556,10388055,26256486
2013-02-08,0,7,89,TRUE,36380071,3255498,10388055,39635569
2013-02-09,1,7,133,TRUE,36380071,3255498,10388055,39635569
2013-02-10,2,7,97,TRUE,36380071,3255498,10388055,39635569
2013-02-11,3,7,80,TRUE,36380071,3255498,10388055,39635569
2013-02-12,4,7,89,TRUE,36380071,3255498,10388055,39635569
2013-02-08,0,8,90,TRUE,41280228,3575060,10388055,44855288
2013-02-09,1,8,133,TRUE,41280228,3575060,10388055,44855288
2013-02-10,2,8,94,TRUE,41280228,3575060,10388055,44855288
2013-02-11,3,8,80,TRUE,41280228,3575060,10388055,44855288
2013-02-12,4,8,87,TRUE,41280228,3575060,10388055,44855288
2013-02-08,0,9,91,TRUE,43804586,4235654,10388055,48040240
2013-02-09,1,9,149,TRUE,43804586,4235654,10388055,48040240
2013-02-10,2,9,97,TRUE,43804586,4235654,10388055,48040240
2013-02-11,3,9,86,TRUE,43804586,4235654,10388055,48040240
2013-02-12,4,9,90,TRUE,43804586,4235654,10388055,48040240
2013-02-08,0,10,91,TRUE,49511497,4352751,10388055,53864248
2013-02-09,1,10,163,TRUE,49511497,4352751,10388055,53864248
2013-02-10,2,10,95,TRUE,49511497,4352751,10388055,53864248
2013-02-11,3,10,80,TRUE,49511497,4352751,10388055,53864248
2013-02-12,4,10,90,TRUE,49511497,4352751,10388055,53864248
2013-02-08,0,11,94,TRUE,50752300,4102493,10388055,54854793
2013-02-09,1,11,166,TRUE,50752300,4102493,10388055,54854793
2013-02-10,2,11,94,TRUE,50752300,4102493,10388055,54854793
2013-02-11,3,11,85,TRUE,50752300,4102493,10388055,54854793
2013-02-12,4,11,89,TRUE,50752300,4102493,10388055,54854793
2013-02-08,0,12,101,TRUE,48271340,3725102,10388055,51996442
2013-02-09,1,12,162,TRUE,48271340,3725102,10388055,51996442
2013-02-10,2,12,99,TRUE,48271340,3725102,10388055,51996442
2013-02-11,3,12,87,TRUE,48271340,3725102,10388055,51996442
2013-02-12,4,12,89,TRUE,48271340,3725102,10388055,51996442
2013-02-08,0,13,118,TRUE,50593221,3709434,10388055,54302655
2013-02-09,1,13,137,TRUE,50593221,3709434,10388055,54302655
2013-02-10,2,13,105,TRUE,50593221,3709434,10388055,54302655
2013-02-11,3,13,92,TRUE,50593221,3709434,10388055,54302655
2013-02-12,4,13,89,TRUE,50593221,3709434,10388055,54302655
2013-02-08,0,14,115,TRUE,53189461,3867277,10388055,57056738
2013-02-09,1,14,137,TRUE,53189461,3867277,10388055,57056738
2013-02-10,2,14,108,TRUE,53189461,3867277,10388055,57056738
2013-02-11,3,14,92,TRUE,53189461,3867277,10388055,57056738
2013-02-12,4,14,91,TRUE,53189461,3867277,10388055,57056738
2013-02-08,0,15,125,TRUE,54787052,3692778,10388055,58479830
2013-02-09,1,15,123,TRUE,54787052,3692778,10388055,58479830
2013-02-10,2,15,117,TRUE,54787052,3692778,10388055,58479830
2013-02-11,3,15,93,TRUE,54787052,3692778,10388055,58479830
2013-02-12,4,15,91,TRUE,54787052,3692778,10388055,58479830
2013-02-08,0,16,136,TRUE,56287190,3363121,10388055,59650311
2013-02-09,1,16,107,TRUE,56287190,3363121,10388055,59650311
2013-02-10,2,16,121,TRUE,56287190,3363121,10388055,59650311
2013-02-11,3,16,93,TRUE,56287190,3363121,10388055,59650311
2013-02-12,4,16,88,TRUE,56287190,3363121,10388055,59650311
2013-02-08,0,17,149,TRUE,58878514,2924553,10388055,61803067
2013-02-09,1,17,106,TRUE,58878514,2924553,10388055,61803067
2013-02-10,2,17,156,TRUE,58878514,2924553,10388055,61803067
2013-02-11,3,17,94,TRUE,58878514,2924553,10388055,61803067
2013-02-12,4,17,88,TRUE,58878514,2924553,10388055,61803067
2013-02-08,0,18,167,TRUE,54782095,2222097,10388055,57004192
2013-02-09,1,18,98,TRUE,54782095,2222097,10388055,57004192
2013-02-10,2,18,160,TRUE,54782095,2222097,10388055,57004192
2013-02-11,3,18,93,TRUE,54782095,2222097,10388055,57004192
2013-02-12,4,18,91,TRUE,54782095,2222097,10388055,57004192
2013-02-08,0,19,185,TRUE,43816635,1647751,10388055,45464386
2013-02-09,1,19,93,TRUE,43816635,1647751,10388055,45464386
2013-02-10,2,19,156,FALSE,43816635,1647751,10388055,45464386
2013-02-11,3,19,94,FALSE,43816635,1647751,10388055,45464386
2013-02-12,4,19,91,FALSE,43816635,1647751,10388055,45464386
2013-02-08,0,20,202,FALSE,36060321,1229771,10388055,37290092
2013-02-09,1,20,93,TRUE,36060321,1229771,10388055,37290092
2013-02-10,2,20,145,FALSE,36060321,1229771,10388055,37290092
2013-02-11,3,20,95,FALSE,36060321,1229771,10388055,37290092
2013-02-12,4,20,87,FALSE,36060321,1229771,10388055,37290092
2013-02-08,0,21,211,TRUE,30450086,926420,10388055,31376506
2013-02-09,1,21,91,TRUE,30450086,926420,10388055,31376506
2013-02-10,2,21,128,TRUE,30450086,926420,10388055,31376506
2013-02-11,3,21,92,TRUE,30450086,926420,10388055,31376506
2013-02-12,4,21,92,TRUE,30450086,926420,10388055,31376506
2013-02-08,0,22,212,FALSE,23724302,711809,10388055,24436111
2013-02-09,1,22,88,TRUE,23724302,711809,10388055,24436111
2013-02-10,2,22,116,FALSE,23724302,711809,10388055,24436111
2013-02-11,3,22,86,FALSE,23724302,711809,10388055,24436111
2013-02-12,4,22,91,TRUE,23724302,711809,10388055,24436111
2013-02-08,0,23,183,FALSE,16703904,586946,10388055,17290850
2013-02-09,1,23,89,TRUE,16703904,586946,10388055,17290850
2013-02-10,2,23,107,FALSE,16703904,586946,10388055,17290850
2013-02-11,3,23,85,FALSE,16703904,586946,10388055,17290850
2013-02-12,4,23,88,TRUE,16703904,586946,10388055,17290850
2014-01-29,0,0,84,FALSE,10664105,428069,10369593,11092174
2014-01-30,1,0,155,FALSE,10664105,428069,10369593,11092174
2014-01-31,2,0,81,FALSE,10664105,428069,10369593,11092174
2014-02-01,3,0,82,FALSE,10664105,428069,10369593,11092174
2014-02-02,4,0,80,FALSE,10664105,428069,10369593,11092174
2014-01-29,0,1,82,FALSE,7069420,403697,10369593,7473117
2014-01-30,1,1,158,FALSE,7069420,403697,10369593,7473117
2014-01-31,2,1,82,FALSE,7069420,403697,10369593,7473117
2014-02-01,3,1,82,FALSE,7069420,403697,10369593,7473117
2014-02-02,4,1,80,FALSE,7069420,403697,10369593,7473117
2014-01-29,0,2,82,FALSE,4976310,439135,10369593,5415445
2014-01-30,1,2,150,FALSE,4976310,439135,10369593,5415445
2014-01-31,2,2,83,FALSE,4976310,439135,10369593,5415445
2014-02-01,3,2,87,FALSE,4976310,439135,10369593,5415445
2014-02-02,4,2,83,FALSE,4976310,439135,10369593,5415445
2014-01-29,0,3,83,FALSE,4047937,540574,10369593,4588511
2014-01-30,1,3,146,FALSE,4047937,540574,10369593,4588511
2014-01-31,2,3,85,FALSE,4047937,540574,10369593,4588511
2014-02-01,3,3,83,FALSE,4047937,540574,10369593,4588511
2014-02-02,4,3,82,TRUE,4047937,540574,10369593,4588511
2014-01-29,0,4,80,FALSE,4811616,777718,10369593,5589334
2014-01-30,1,4,154,FALSE,4811616,777718,10369593,5589334
2014-01-31,2,4,87,FALSE,4811616,777718,10369593,5589334
2014-02-01,3,4,82,FALSE,4811616,777718,10369593,5589334
2014-02-02,4,4,85,FALSE,4811616,777718,10369593,5589334
2014-01-29,0,5,81,FALSE,10497962,1328908,10369593,11826870
2014-01-30,1,5,148,FALSE,10497962,1328908,10369593,11826870
2014-01-31,2,5,87,FALSE,10497962,1328908,10369593,11826870
2014-02-01,3,5,82,FALSE,10497962,1328908,10369593,11826870
2014-02-02,4,5,87,FALSE,10497962,1328908,10369593,11826870
2014-01-29,0,6,83,FALSE,22667811,2378576,10369593,25046387
2014-01-30,1,6,152,FALSE,22667811,2378576,10369593,25046387
2014-01-31,2,6,89,FALSE,22667811,2378576,10369593,25046387
2014-02-01,3,6,80,FALSE,22667811,2378576,10369593,25046387
2014-02-02,4,6,84,FALSE,22667811,2378576,10369593,25046387
2014-01-29,0,7,84,FALSE,34632727,2928182,10369593,37560909
2014-01-30,1,7,168,FALSE,34632727,2928182,10369593,37560909
2014-01-31,2,7,87,FALSE,34632727,2928182,10369593,37560909
2014-02-01,3,7,80,FALSE,34632727,2928182,10369593,37560909
2014-02-02,4,7,81,FALSE,34632727,2928182,10369593,37560909
2014-01-29,0,8,85,FALSE,39337003,3200702,10369593,42537705
2014-01-30,1,8,174,FALSE,39337003,3200702,10369593,42537705
2014-01-31,2,8,90,FALSE,39337003,3200702,10369593,42537705
2014-02-01,3,8,79,FALSE,39337003,3200702,10369593,42537705
2014-02-02,4,8,81,FALSE,39337003,3200702,10369593,42537705
2014-01-29,0,9,85,FALSE,42167656,3756916,10369593,45924572
2014-01-30,1,9,177,TRUE,42167656,3756916,10369593,45924572
2014-01-31,2,9,89,FALSE,42167656,3756916,10369593,45924572
2014-02-01,3,9,79,FALSE,42167656,3756916,10369593,45924572
2014-02-02,4,9,82,FALSE,42167656,3756916,10369593,45924572
2014-01-29,0,10,87,FALSE,47533535,3853842,10369593,51387377
2014-01-30,1,10,203,FALSE,47533535,3853842,10369593,51387377
2014-01-31,2,10,87,FALSE,47533535,3853842,10369593,51387377
2014-02-01,3,10,81,FALSE,47533535,3853842,10369593,51387377
2014-02-02,4,10,84,FALSE,47533535,3853842,10369593,51387377
2014-01-29,0,11,92,FALSE,48787949,3627356,10369593,52415305
2014-01-30,1,11,205,FALSE,48787949,3627356,10369593,52415305
2014-01-31,2,11,88,FALSE,48787949,3627356,10369593,52415305
2014-02-01,3,11,82,FALSE,48787949,3627356,10369593,52415305
2014-02-02,4,11,84,FALSE,48787949,3627356,10369593,52415305
2014-01-29,0,12,102,FALSE,46535186,3279596,10369593,49814782
2014-01-30,1,12,225,TRUE,46535186,3279596,10369593,49814782
2014-01-31,2,12,97,FALSE,46535186,3279596,10369593,49814782
2014-02-01,3,12,85,FALSE,46535186,3279596,10369593,49814782
2014-02-02,4,12,87,FALSE,46535186,3279596,10369593,49814782
2014-01-29,0,13,113,FALSE,48787900,3281063,10369593,52068963
2014-01-30,1,13,216,FALSE,48787900,3281063,10369593,52068963
2014-01-31,2,13,107,FALSE,48787900,3281063,10369593,52068963
2014-02-01,3,13,88,FALSE,48787900,3281063,10369593,52068963
2014-02-02,4,13,89,FALSE,48787900,3281063,10369593,52068963
2014-01-29,0,14,125,FALSE,51182357,3402421,10369593,54584778
2014-01-30,1,14,206,FALSE,51182357,3402421,10369593,54584778
2014-01-31,2,14,119,FALSE,51182357,3402421,10369593,54584778
2014-02-01,3,14,88,FALSE,51182357,3402421,10369593,54584778
2014-02-02,4,14,91,FALSE,51182357,3402421,10369593,54584778
2014-01-29,0,15,139,FALSE,52688987,3237139,10369593,55926126
2014-01-30,1,15,187,FALSE,52688987,3237139,10369593,55926126
2014-01-31,2,15,135,FALSE,52688987,3237139,10369593,55926126
2014-02-01,3,15,89,TRUE,52688987,3237139,10369593,55926126
2014-02-02,4,15,89,FALSE,52688987,3237139,10369593,55926126
2014-01-29,0,16,142,FALSE,54145365,2947730,10369593,57093095
2014-01-30,1,16,172,FALSE,54145365,2947730,10369593,57093095
2014-01-31,2,16,146,FALSE,54145365,2947730,10369593,57093095
2014-02-01,3,16,91,FALSE,54145365,2947730,10369593,57093095
2014-02-02,4,16,92,FALSE,54145365,2947730,10369593,57093095
2014-01-29,0,17,156,FALSE,56495908,2544881,10369593,59040789
2014-01-30,1,17,157,FALSE,56495908,2544881,10369593,59040789
2014-01-31,2,17,133,FALSE,56495908,2544881,10369593,59040789
2014-02-01,3,17,94,FALSE,56495908,2544881,10369593,59040789
2014-02-02,4,17,88,FALSE,56495908,2544881,10369593,59040789
2014-01-29,0,18,186,FALSE,51935152,1899864,10369593,53835016
2014-01-30,1,18,146,FALSE,51935152,1899864,10369593,53835016
2014-01-31,2,18,144,FALSE,51935152,1899864,10369593,53835016
2014-02-01,3,18,90,TRUE,51935152,1899864,10369593,53835016
2014-02-02,4,18,95,FALSE,51935152,1899864,10369593,53835016
2014-01-29,0,19,194,FALSE,41347664,1393542,10369593,42741206
2014-01-30,1,19,134,FALSE,41347664,1393542,10369593,42741206
2014-01-31,2,19,168,FALSE,41347664,1393542,10369593,42741206
2014-02-01,3,19,98,FALSE,41347664,1393542,10369593,42741206
2014-02-02,4,19,91,FALSE,41347664,1393542,10369593,42741206
2014-01-29,0,20,222,FALSE,33856752,1026109,10369593,34882861
2014-01-30,1,20,121,FALSE,33856752,1026109,10369593,34882861
2014-01-31,2,20,161,FALSE,33856752,1026109,10369593,34882861
2014-02-01,3,20,102,FALSE,33856752,1026109,10369593,34882861
2014-02-02,4,20,85,FALSE,33856752,1026109,10369593,34882861
2014-01-29,0,21,239,FALSE,28500236,773565,10369593,29273801
2014-01-30,1,21,110,FALSE,28500236,773565,10369593,29273801
2014-01-31,2,21,144,FALSE,28500236,773565,10369593,29273801
2014-02-01,3,21,90,TRUE,28500236,773565,10369593,29273801
2014-02-02,4,21,90,FALSE,28500236,773565,10369593,29273801
2014-01-29,0,22,222,FALSE,22198420,586052,10369593,22784472
2014-01-30,1,22,102,FALSE,22198420,586052,10369593,22784472
2014-01-31,2,22,127,FALSE,22198420,586052,10369593,22784472
2014-02-01,3,22,96,FALSE,22198420,586052,10369593,22784472
2014-02-02,4,22,87,FALSE,22198420,586052,10369593,22784472
2014-01-29,0,23,229,FALSE,15628431,493217,10369593,16121648
2014-01-30,1,23,99,FALSE,15628431,493217,10369593,16121648
2014-01-31,2,23,114,FALSE,15628431,493217,10369593,16121648
2014-02-01,3,23,87,FALSE,15628431,493217,10369593,16121648
2014-02-02,4,23,85,FALSE,15628431,493217,10369593,16121648
2015-02-17,0,0,97,TRUE,9634333,349885,10297138,9984218
2015-02-18,1,0,219,FALSE,9634333,349885,10297138,9984218
2015-02-19,2,0,84,FALSE,9634333,349885,10297138,9984218
2015-02-21,3,0,81,FALSE,9634333,349885,10297138,9984218
2015-02-22,4,0,82,TRUE,9634333,349885,10297138,9984218
2015-02-17,0,1,81,FALSE,6379793,334236,10297138,6714029
2015-02-18,1,1,201,FALSE,6379793,334236,10297138,6714029
2015-02-19,2,1,85,FALSE,6379793,334236,10297138,6714029
2015-02-21,3,1,81,FALSE,6379793,334236,10297138,6714029
2015-02-22,4,1,81,FALSE,6379793,334236,10297138,6714029
2015-02-17,0,2,83,FALSE,4484777,350976,10297138,4835753
2015-02-18,1,2,188,FALSE,4484777,350976,10297138,4835753
2015-02-19,2,2,83,FALSE,4484777,350976,10297138,4835753
2015-02-21,3,2,81,FALSE,4484777,350976,10297138,4835753
2015-02-22,4,2,81,FALSE,4484777,350976,10297138,4835753
2015-02-17,0,3,92,TRUE,3678378,420472,10297138,4098850
2015-02-18,1,3,173,FALSE,3678378,420472,10297138,4098850
2015-02-19,2,3,90,FALSE,3678378,420472,10297138,4098850
2015-02-21,3,3,79,FALSE,3678378,420472,10297138,4098850
2015-02-22,4,3,86,TRUE,3678378,420472,10297138,4098850
2015-02-17,0,4,82,FALSE,4420664,625854,10297138,5046518
2015-02-18,1,4,178,FALSE,4420664,625854,10297138,5046518
2015-02-19,2,4,87,FALSE,4420664,625854,10297138,5046518
2015-02-21,3,4,84,FALSE,4420664,625854,10297138,5046518
2015-02-22,4,4,84,FALSE,4420664,625854,10297138,5046518
2015-02-17,0,5,83,FALSE,9802332,1129404,10297138,10931736
2015-02-18,1,5,166,FALSE,9802332,1129404,10297138,10931736
2015-02-19,2,5,88,FALSE,9802332,1129404,10297138,10931736
2015-02-21,3,5,79,FALSE,9802332,1129404,10297138,10931736
2015-02-22,4,5,83,FALSE,9802332,1129404,10297138,10931736
2015-02-17,0,6,101,FALSE,20616664,2010425,10297138,22627089
2015-02-18,1,6,157,FALSE,20616664,2010425,10297138,22627089
2015-02-19,2,6,89,FALSE,20616664,2010425,10297138,22627089
2015-02-21,3,6,81,FALSE,20616664,2010425,10297138,22627089
2015-02-22,4,6,87,TRUE,20616664,2010425,10297138,22627089
2015-02-17,0,7,96,FALSE,30952977,2482074,10297138,33435051
2015-02-18,1,7,181,FALSE,30952977,2482074,10297138,33435051
2015-02-19,2,7,89,FALSE,30952977,2482074,10297138,33435051
2015-02-21,3,7,83,FALSE,30952977,2482074,10297138,33435051
2015-02-22,4,7,82,FALSE,30952977,2482074,10297138,33435051
2015-02-17,0,8,93,FALSE,35281079,2663525,10297138,37944604
2015-02-18,1,8,171,FALSE,35281079,2663525,10297138,37944604
2015-02-19,2,8,94,FALSE,35281079,2663525,10297138,37944604
2015-02-21,3,8,83,FALSE,35281079,2663525,10297138,37944604
2015-02-22,4,8,79,FALSE,35281079,2663525,10297138,37944604
2015-02-17,0,9,86,FALSE,38254802,3126358,10297138,41381160
2015-02-18,1,9,182,FALSE,38254802,3126358,10297138,41381160
2015-02-19,2,9,94,FALSE,38254802,3126358,10297138,41381160
2015-02-21,3,9,85,FALSE,38254802,3126358,10297138,41381160
2015-02-22,4,9,82,FALSE,38254802,3126358,10297138,41381160
2015-02-17,0,10,93,FALSE,43069839,3179672,10297138,46249511
2015-02-18,1,10,203,FALSE,43069839,3179672,10297138,46249511
2015-02-19,2,10,99,FALSE,43069839,3179672,10297138,46249511
2015-02-21,3,10,86,FALSE,43069839,3179672,10297138,46249511
2015-02-22,4,10,81,FALSE,43069839,3179672,10297138,46249511
2015-02-17,0,11,90,FALSE,44201190,2984235,10297138,47185425
2015-02-18,1,11,215,FALSE,44201190,2984235,10297138,47185425
2015-02-19,2,11,103,FALSE,44201190,2984235,10297138,47185425
2015-02-21,3,11,84,FALSE,44201190,2984235,10297138,47185425
2015-02-22,4,11,81,FALSE,44201190,2984235,10297138,47185425
2015-02-17,0,12,112,FALSE,42295246,2695285,10297138,44990531
2015-02-18,1,12,242,FALSE,42295246,2695285,10297138,44990531
2015-02-19,2,12,113,FALSE,42295246,2695285,10297138,44990531
2015-02-21,3,12,88,TRUE,42295246,2695285,10297138,44990531
2015-02-22,4,12,84,FALSE,42295246,2695285,10297138,44990531
2015-02-17,0,13,113,FALSE,44362355,2700678,10297138,47063033
2015-02-18,1,13,251,FALSE,44362355,2700678,10297138,47063033
2015-02-19,2,13,128,FALSE,44362355,2700678,10297138,47063033
2015-02-21,3,13,92,FALSE,44362355,2700678,10297138,47063033
2015-02-22,4,13,83,FALSE,44362355,2700678,10297138,47063033
2015-02-17,0,14,126,FALSE,46418602,2792621,10297138,49211223
2015-02-18,1,14,243,FALSE,46418602,2792621,10297138,49211223
2015-02-19,2,14,143,FALSE,46418602,2792621,10297138,49211223
2015-02-21,3,14,88,FALSE,46418602,2792621,10297138,49211223
2015-02-22,4,14,85,FALSE,46418602,2792621,10297138,49211223
2015-02-17,0,15,139,FALSE,47735132,2666216,10297138,50401348
2015-02-18,1,15,203,FALSE,47735132,2666216,10297138,50401348
2015-02-19,2,15,158,FALSE,47735132,2666216,10297138,50401348
2015-02-21,3,15,94,TRUE,47735132,2666216,10297138,50401348
2015-02-22,4,15,86,FALSE,47735132,2666216,10297138,50401348
2015-02-17,0,16,151,FALSE,49047511,2436203,10297138,51483714
2015-02-18,1,16,196,FALSE,49047511,2436203,10297138,51483714
2015-02-19,2,16,147,FALSE,49047511,2436203,10297138,51483714
2015-02-21,3,16,94,FALSE,49047511,2436203,10297138,51483714
2015-02-22,4,16,86,FALSE,49047511,2436203,10297138,51483714
2015-02-17,0,17,167,FALSE,50888140,2099188,10297138,52987328
2015-02-18,1,17,182,FALSE,50888140,2099188,10297138,52987328
2015-02-19,2,17,183,FALSE,50888140,2099188,10297138,52987328
2015-02-21,3,17,93,FALSE,50888140,2099188,10297138,52987328
2015-02-22,4,17,87,FALSE,50888140,2099188,10297138,52987328
2015-02-17,0,18,176,FALSE,46397761,1550369,10297138,47948130
2015-02-18,1,18,171,FALSE,46397761,1550369,10297138,47948130
2015-02-19,2,18,200,FALSE,46397761,1550369,10297138,47948130
2015-02-21,3,18,87,TRUE,46397761,1550369,10297138,47948130
2015-02-22,4,18,86,FALSE,46397761,1550369,10297138,47948130
2015-02-17,0,19,187,FALSE,36965248,1132193,10297138,38097441
2015-02-18,1,19,160,FALSE,36965248,1132193,10297138,38097441
2015-02-19,2,19,184,FALSE,36965248,1132193,10297138,38097441
2015-02-21,3,19,92,FALSE,36965248,1132193,10297138,38097441
2015-02-22,4,19,87,FALSE,36965248,1132193,10297138,38097441
2015-02-17,0,20,227,FALSE,30448851,831245,10297138,31280096
2015-02-18,1,20,144,FALSE,30448851,831245,10297138,31280096
2015-02-19,2,20,206,FALSE,30448851,831245,10297138,31280096
2015-02-21,3,20,90,FALSE,30448851,831245,10297138,31280096
2015-02-22,4,20,87,FALSE,30448851,831245,10297138,31280096
2015-02-17,0,21,243,FALSE,25661003,612517,10297138,26273520
2015-02-18,1,21,126,FALSE,25661003,612517,10297138,26273520
2015-02-19,2,21,192,FALSE,25661003,612517,10297138,26273520
2015-02-21,3,21,90,TRUE,25661003,612517,10297138,26273520
2015-02-22,4,21,86,FALSE,25661003,612517,10297138,26273520
2015-02-17,0,22,249,FALSE,20075361,470081,10297138,20545442
2015-02-18,1,22,113,FALSE,20075361,470081,10297138,20545442
2015-02-19,2,22,165,FALSE,20075361,470081,10297138,20545442
2015-02-21,3,22,88,FALSE,20075361,470081,10297138,20545442
2015-02-22,4,22,85,FALSE,20075361,470081,10297138,20545442
2015-02-17,0,23,246,FALSE,14137960,396762,10297138,14534722
2015-02-18,1,23,104,FALSE,14137960,396762,10297138,14534722
2015-02-19,2,23,141,FALSE,14137960,396762,10297138,14534722
2015-02-21,3,23,88,FALSE,14137960,396762,10297138,14534722
2015-02-22,4,23,79,FALSE,14137960,396762,10297138,14534722
2016-02-05,0,0,89,FALSE,8806595,229256,10204057,9035851
2016-02-06,1,0,84,FALSE,8806595,229256,10204057,9035851
2016-02-08,2,0,82,FALSE,8806595,229256,10204057,9035851
2016-02-09,3,0,81,FALSE,8806595,229256,10204057,9035851
2016-02-10,4,0,93,FALSE,8806595,229256,10204057,9035851
2016-02-05,0,1,86,FALSE,5828764,196764,10204057,6025528
2016-02-06,1,1,84,FALSE,5828764,196764,10204057,6025528
2016-02-08,2,1,78,FALSE,5828764,196764,10204057,6025528
2016-02-09,3,1,85,FALSE,5828764,196764,10204057,6025528
2016-02-10,4,1,91,FALSE,5828764,196764,10204057,6025528
2016-02-05,0,2,79,FALSE,4114920,209931,10204057,4324851
2016-02-06,1,2,88,FALSE,4114920,209931,10204057,4324851
2016-02-08,2,2,92,FALSE,4114920,209931,10204057,4324851
2016-02-09,3,2,85,FALSE,4114920,209931,10204057,4324851
2016-02-10,4,2,93,FALSE,4114920,209931,10204057,4324851
2016-02-05,0,3,99,FALSE,3401788,252937,10204057,3654725
2016-02-06,1,3,87,FALSE,3401788,252937,10204057,3654725
2016-02-08,2,3,80,FALSE,3401788,252937,10204057,3654725
2016-02-09,3,3,81,FALSE,3401788,252937,10204057,3654725
2016-02-10,4,3,78,FALSE,3401788,252937,10204057,3654725
2016-02-05,0,4,80,FALSE,4187222,360450,10204057,4547672
2016-02-06,1,4,91,FALSE,4187222,360450,10204057,4547672
2016-02-08,2,4,93,FALSE,4187222,360450,10204057,4547672
2016-02-09,3,4,88,FALSE,4187222,360450,10204057,4547672
2016-02-10,4,4,76,FALSE,4187222,360450,10204057,4547672
2016-02-05,0,5,95,FALSE,9466891,672021,10204057,10138912
2016-02-06,1,5,89,FALSE,9466891,672021,10204057,10138912
2016-02-08,2,5,92,FALSE,9466891,672021,10204057,10138912
2016-02-09,3,5,96,FALSE,9466891,672021,10204057,10138912
2016-02-10,4,5,75,FALSE,9466891,672021,10204057,10138912
2016-02-05,0,6,77,FALSE,20096660,1255495,10204057,21352155
2016-02-06,1,6,98,FALSE,20096660,1255495,10204057,21352155
2016-02-08,2,6,90,FALSE,20096660,1255495,10204057,21352155
2016-02-09,3,6,97,FALSE,20096660,1255495,10204057,21352155
2016-02-10,4,6,75,FALSE,20096660,1255495,10204057,21352155
2016-02-05,0,7,89,FALSE,29291712,1606191,10204057,30897903
2016-02-06,1,7,101,FALSE,29291712,1606191,10204057,30897903
2016-02-08,2,7,90,FALSE,29291712,1606191,10204057,30897903
2016-02-09,3,7,84,FALSE,29291712,1606191,10204057,30897903
2016-02-10,4,7,87,FALSE,29291712,1606191,10204057,30897903
2016-02-05,0,8,82,FALSE,32914849,1710684,10204057,34625533
2016-02-06,1,8,104,FALSE,32914849,1710684,10204057,34625533
2016-02-08,2,8,93,FALSE,32914849,1710684,10204057,34625533
2016-02-09,3,8,82,FALSE,32914849,1710684,10204057,34625533
2016-02-10,4,8,85,FALSE,32914849,1710684,10204057,34625533
2016-02-05,0,9,83,FALSE,35812247,2011238,10204057,37823485
2016-02-06,1,9,111,FALSE,35812247,2011238,10204057,37823485
2016-02-08,2,9,92,FALSE,35812247,2011238,10204057,37823485
2016-02-09,3,9,82,FALSE,35812247,2011238,10204057,37823485
2016-02-10,4,9,84,FALSE,35812247,2011238,10204057,37823485
2016-02-05,0,10,86,FALSE,39873911,2037362,10204057,41911273
2016-02-06,1,10,115,FALSE,39873911,2037362,10204057,41911273
2016-02-08,2,10,91,FALSE,39873911,2037362,10204057,41911273
2016-02-09,3,10,83,FALSE,39873911,2037362,10204057,41911273
2016-02-10,4,10,84,FALSE,39873911,2037362,10204057,41911273
2016-02-05,0,11,88,FALSE,40816395,1901985,10204057,42718380
2016-02-06,1,11,109,FALSE,40816395,1901985,10204057,42718380
2016-02-08,2,11,91,FALSE,40816395,1901985,10204057,42718380
2016-02-09,3,11,82,FALSE,40816395,1901985,10204057,42718380
2016-02-10,4,11,84,FALSE,40816395,1901985,10204057,42718380
2016-02-05,0,12,89,FALSE,39335493,1709689,10204057,41045182
2016-02-06,1,12,113,FALSE,39335493,1709689,10204057,41045182
2016-02-08,2,12,104,FALSE,39335493,1709689,10204057,41045182
2016-02-09,3,12,86,FALSE,39335493,1709689,10204057,41045182
2016-02-10,4,12,84,FALSE,39335493,1709689,10204057,41045182
2016-02-05,0,13,95,FALSE,41250398,1735636,10204057,42986034
2016-02-06,1,13,123,FALSE,41250398,1735636,10204057,42986034
2016-02-08,2,13,118,FALSE,41250398,1735636,10204057,42986034
2016-02-09,3,13,92,FALSE,41250398,1735636,10204057,42986034
2016-02-10,4,13,87,FALSE,41250398,1735636,10204057,42986034
2016-02-05,0,14,102,FALSE,42982068,1805336,10204057,44787404
2016-02-06,1,14,124,FALSE,42982068,1805336,10204057,44787404
2016-02-08,2,14,133,FALSE,42982068,1805336,10204057,44787404
2016-02-09,3,14,95,FALSE,42982068,1805336,10204057,44787404
2016-02-10,4,14,88,FALSE,42982068,1805336,10204057,44787404
2016-02-05,0,15,129,FALSE,44144715,1737569,10204057,45882284
2016-02-06,1,15,123,FALSE,44144715,1737569,10204057,45882284
2016-02-08,2,15,150,FALSE,44144715,1737569,10204057,45882284
2016-02-09,3,15,94,FALSE,44144715,1737569,10204057,45882284
2016-02-10,4,15,89,FALSE,44144715,1737569,10204057,45882284
2016-02-05,0,16,118,FALSE,45541335,1603313,10204057,47144648
2016-02-06,1,16,127,FALSE,45541335,1603313,10204057,47144648
2016-02-08,2,16,142,FALSE,45541335,1603313,10204057,47144648
2016-02-09,3,16,93,FALSE,45541335,1603313,10204057,47144648
2016-02-10,4,16,89,FALSE,45541335,1603313,10204057,47144648
2016-02-05,0,17,124,FALSE,47316089,1387231,10204057,48703320
2016-02-06,1,17,127,FALSE,47316089,1387231,10204057,48703320
2016-02-08,2,17,180,FALSE,47316089,1387231,10204057,48703320
2016-02-09,3,17,93,FALSE,47316089,1387231,10204057,48703320
2016-02-10,4,17,87,FALSE,47316089,1387231,10204057,48703320
2016-02-05,0,18,133,FALSE,42815180,1011860,10204057,43827040
2016-02-06,1,18,116,FALSE,42815180,1011860,10204057,43827040
2016-02-08,2,18,192,FALSE,42815180,1011860,10204057,43827040
2016-02-09,3,18,91,FALSE,42815180,1011860,10204057,43827040
2016-02-10,4,18,86,FALSE,42815180,1011860,10204057,43827040
2016-02-05,0,19,138,FALSE,34080763,733817,10204057,34814580
2016-02-06,1,19,127,FALSE,34080763,733817,10204057,34814580
2016-02-08,2,19,192,FALSE,34080763,733817,10204057,34814580
2016-02-09,3,19,86,FALSE,34080763,733817,10204057,34814580
2016-02-10,4,19,83,FALSE,34080763,733817,10204057,34814580
2016-02-05,0,20,134,FALSE,27891373,529182,10204057,28420555
2016-02-06,1,20,120,FALSE,27891373,529182,10204057,28420555
2016-02-08,2,20,187,FALSE,27891373,529182,10204057,28420555
2016-02-09,3,20,84,FALSE,27891373,529182,10204057,28420555
2016-02-10,4,20,84,FALSE,27891373,529182,10204057,28420555
2016-02-05,0,21,117,FALSE,23587756,383847,10204057,23971603
2016-02-06,1,21,114,FALSE,23587756,383847,10204057,23971603
2016-02-08,2,21,164,FALSE,23587756,383847,10204057,23971603
2016-02-09,3,21,87,FALSE,23587756,383847,10204057,23971603
2016-02-10,4,21,85,FALSE,23587756,383847,10204057,23971603
2016-02-05,0,22,110,FALSE,18358359,289108,10204057,18647467
2016-02-06,1,22,107,FALSE,18358359,289108,10204057,18647467
2016-02-08,2,22,141,FALSE,18358359,289108,10204057,18647467
2016-02-09,3,22,85,FALSE,18358359,289108,10204057,18647467
2016-02-10,4,22,83,FALSE,18358359,289108,10204057,18647467
2016-02-05,0,23,111,FALSE,12942755,234177,10204057,13176932
2016-02-06,1,23,102,FALSE,12942755,234177,10204057,13176932
2016-02-08,2,23,124,FALSE,12942755,234177,10204057,13176932
2016-02-09,3,23,81,FALSE,12942755,234177,10204057,13176932
2016-02-10,4,23,87,FALSE,12942755,234177,10204057,13176932
2017-01-26,0,0,85,TRUE,8106470,495853,10124579,8602323
2017-01-27,1,0,154,TRUE,8106470,495853,10124579,8602323
2017-01-28,2,0,79,FALSE,8106470,495853,10124579,8602323
2017-01-29,3,0,81,FALSE,8106470,495853,10124579,8602323
2017-01-30,4,0,84,TRUE,8106470,495853,10124579,8602323
2017-01-26,0,1,89,TRUE,5274119,149513,10124579,5423632
2017-01-27,1,1,149,FALSE,5274119,149513,10124579,5423632
2017-01-28,2,1,80,FALSE,5274119,149513,10124579,5423632
2017-01-29,3,1,80,FALSE,5274119,149513,10124579,5423632
2017-01-30,4,1,87,TRUE,5274119,149513,10124579,5423632
2017-01-26,0,2,91,TRUE,3717284,157598,10124579,3874882
2017-01-27,1,2,143,FALSE,3717284,157598,10124579,3874882
2017-01-28,2,2,77,FALSE,3717284,157598,10124579,3874882
2017-01-29,3,2,89,FALSE,3717284,157598,10124579,3874882
2017-01-30,4,2,89,TRUE,3717284,157598,10124579,3874882
2017-01-26,0,3,94,TRUE,3109055,199370,10124579,3308425
2017-01-27,1,3,162,TRUE,3109055,199370,10124579,3308425
2017-01-28,2,3,79,FALSE,3109055,199370,10124579,3308425
2017-01-29,3,3,87,FALSE,3109055,199370,10124579,3308425
2017-01-30,4,3,95,TRUE,3109055,199370,10124579,3308425
2017-01-26,0,4,93,TRUE,3910621,286876,10124579,4197497
2017-01-27,1,4,149,FALSE,3910621,286876,10124579,4197497
2017-01-28,2,4,79,FALSE,3910621,286876,10124579,4197497
2017-01-29,3,4,86,FALSE,3910621,286876,10124579,4197497
2017-01-30,4,4,92,TRUE,3910621,286876,10124579,4197497
2017-01-26,0,5,86,TRUE,9496769,545898,10124579,10042667
2017-01-27,1,5,165,FALSE,9496769,545898,10124579,10042667
2017-01-28,2,5,78,FALSE,9496769,545898,10124579,10042667
2017-01-29,3,5,83,FALSE,9496769,545898,10124579,10042667
2017-01-30,4,5,106,TRUE,9496769,545898,10124579,10042667
2017-01-26,0,6,91,TRUE,20719352,1071501,10124579,21790853
2017-01-27,1,6,157,FALSE,20719352,1071501,10124579,21790853
2017-01-28,2,6,84,FALSE,20719352,1071501,10124579,21790853
2017-01-29,3,6,85,FALSE,20719352,1071501,10124579,21790853
2017-01-30,4,6,95,TRUE,20719352,1071501,10124579,21790853
2017-01-26,0,7,81,TRUE,29024546,1348831,10124579,30373377
2017-01-27,1,7,170,FALSE,29024546,1348831,10124579,30373377
2017-01-28,2,7,87,FALSE,29024546,1348831,10124579,30373377
2017-01-29,3,7,80,FALSE,29024546,1348831,10124579,30373377
2017-01-30,4,7,83,TRUE,29024546,1348831,10124579,30373377
2017-01-26,0,8,83,TRUE,32089660,1415330,10124579,33504990
2017-01-27,1,8,158,FALSE,32089660,1415330,10124579,33504990
2017-01-28,2,8,92,FALSE,32089660,1415330,10124579,33504990
2017-01-29,3,8,80,FALSE,32089660,1415330,10124579,33504990
2017-01-30,4,8,84,TRUE,32089660,1415330,10124579,33504990
2017-01-26,0,9,85,TRUE,34525129,1636634,10124579,36161763
2017-01-27,1,9,144,FALSE,34525129,1636634,10124579,36161763
2017-01-28,2,9,93,FALSE,34525129,1636634,10124579,36161763
2017-01-29,3,9,80,FALSE,34525129,1636634,10124579,36161763
2017-01-30,4,9,90,TRUE,34525129,1636634,10124579,36161763
2017-01-26,0,10,92,TRUE,37893468,1660329,10124579,39553797
2017-01-27,1,10,164,FALSE,37893468,1660329,10124579,39553797
2017-01-28,2,10,90,FALSE,37893468,1660329,10124579,39553797
2017-01-29,3,10,81,FALSE,37893468,1660329,10124579,39553797
2017-01-30,4,10,82,TRUE,37893468,1660329,10124579,39553797
2017-01-26,0,11,104,TRUE,38607601,1528798,10124579,40136399
2017-01-27,1,11,152,FALSE,38607601,1528798,10124579,40136399
2017-01-28,2,11,89,FALSE,38607601,1528798,10124579,40136399
2017-01-29,3,11,83,FALSE,38607601,1528798,10124579,40136399
2017-01-30,4,11,90,TRUE,38607601,1528798,10124579,40136399
2017-01-26,0,12,102,TRUE,37312037,1365188,10124579,38677225
2017-01-27,1,12,150,FALSE,37312037,1365188,10124579,38677225
2017-01-28,2,12,100,FALSE,37312037,1365188,10124579,38677225
2017-01-29,3,12,84,TRUE,37312037,1365188,10124579,38677225
2017-01-30,4,12,83,TRUE,37312037,1365188,10124579,38677225
2017-01-26,0,13,111,TRUE,39438713,1404810,10124579,40843523
2017-01-27,1,13,144,FALSE,39438713,1404810,10124579,40843523
2017-01-28,2,13,111,FALSE,39438713,1404810,10124579,40843523
2017-01-29,3,13,86,FALSE,39438713,1404810,10124579,40843523
2017-01-30,4,13,84,TRUE,39438713,1404810,10124579,40843523
2017-01-26,0,14,124,TRUE,40907445,1445503,10124579,42352948
2017-01-27,1,14,148,FALSE,40907445,1445503,10124579,42352948
2017-01-28,2,14,123,FALSE,40907445,1445503,10124579,42352948
2017-01-29,3,14,89,FALSE,40907445,1445503,10124579,42352948
2017-01-30,4,14,93,TRUE,40907445,1445503,10124579,42352948
2017-01-26,0,15,139,TRUE,41972299,1390555,10124579,43362854
2017-01-27,1,15,139,FALSE,41972299,1390555,10124579,43362854
2017-01-28,2,15,141,FALSE,41972299,1390555,10124579,43362854
2017-01-29,3,15,93,TRUE,41972299,1390555,10124579,43362854
2017-01-30,4,15,94,TRUE,41972299,1390555,10124579,43362854
2017-01-26,0,16,139,TRUE,43608358,1292209,10124579,44900567
2017-01-27,1,16,122,FALSE,43608358,1292209,10124579,44900567
2017-01-28,2,16,150,FALSE,43608358,1292209,10124579,44900567
2017-01-29,3,16,99,FALSE,43608358,1292209,10124579,44900567
2017-01-30,4,16,93,TRUE,43608358,1292209,10124579,44900567
2017-01-26,0,17,165,TRUE,45467256,1122016,10124579,46589272
2017-01-27,1,17,129,FALSE,45467256,1122016,10124579,46589272
2017-01-28,2,17,156,FALSE,45467256,1122016,10124579,46589272
2017-01-29,3,17,100,TRUE,45467256,1122016,10124579,46589272
2017-01-30,4,17,92,TRUE,45467256,1122016,10124579,46589272
2017-01-26,0,18,183,TRUE,40898920,816480,10124579,41715400
2017-01-27,1,18,110,FALSE,40898920,816480,10124579,41715400
2017-01-28,2,18,160,FALSE,40898920,816480,10124579,41715400
2017-01-29,3,18,101,TRUE,40898920,816480,10124579,41715400
2017-01-30,4,18,90,TRUE,40898920,816480,10124579,41715400
2017-01-26,0,19,195,TRUE,32176596,577082,10124579,32753678
2017-01-27,1,19,113,FALSE,32176596,577082,10124579,32753678
2017-01-28,2,19,155,FALSE,32176596,577082,10124579,32753678
2017-01-29,3,19,99,TRUE,32176596,577082,10124579,32753678
2017-01-30,4,19,87,TRUE,32176596,577082,10124579,32753678
2017-01-26,0,20,185,TRUE,25941065,414271,10124579,26355336
2017-01-27,1,20,107,FALSE,25941065,414271,10124579,26355336
2017-01-28,2,20,144,FALSE,25941065,414271,10124579,26355336
2017-01-29,3,20,100,TRUE,25941065,414271,10124579,26355336
2017-01-30,4,20,84,TRUE,25941065,414271,10124579,26355336
2017-01-26,0,21,192,TRUE,21876270,298239,10124579,22174509
2017-01-27,1,21,100,FALSE,21876270,298239,10124579,22174509
2017-01-28,2,21,128,FALSE,21876270,298239,10124579,22174509
2017-01-29,3,21,98,TRUE,21876270,298239,10124579,22174509
2017-01-30,4,21,84,TRUE,21876270,298239,10124579,22174509
2017-01-26,0,22,212,TRUE,16887839,229728,10124579,17117567
2017-01-27,1,22,94,FALSE,16887839,229728,10124579,17117567
2017-01-28,2,22,115,FALSE,16887839,229728,10124579,17117567
2017-01-29,3,22,90,TRUE,16887839,229728,10124579,17117567
2017-01-30,4,22,86,TRUE,16887839,229728,10124579,17117567
2017-01-26,0,23,207,TRUE,11783234,188312,10124579,11971546
2017-01-27,1,23,90,FALSE,11783234,188312,10124579,11971546
2017-01-28,2,23,108,FALSE,11783234,188312,10124579,11971546
2017-01-29,3,23,93,TRUE,11783234,188312,10124579,11971546
2017-01-30,4,23,85,TRUE,11783234,188312,10124579,11971546
2018-02-14,0,0,91,FALSE,6747383,132348,10049607,6879731
2018-02-15,1,0,123,FALSE,6747383,132348,10049607,6879731
2018-02-16,2,0,76,FALSE,6747383,132348,10049607,6879731
2018-02-17,3,0,86,FALSE,6747383,132348,10049607,6879731
2018-02-18,4,0,76,FALSE,6747383,132348,10049607,6879731
2018-02-14,0,1,87,FALSE,4517413,130171,10049607,4647584
2018-02-15,1,1,135,FALSE,4517413,130171,10049607,4647584
2018-02-16,2,1,87,FALSE,4517413,130171,10049607,4647584
2018-02-17,3,1,84,FALSE,4517413,130171,10049607,4647584
2018-02-18,4,1,86,FALSE,4517413,130171,10049607,4647584
2018-02-14,0,2,88,FALSE,3273415,140399,10049607,3413814
2018-02-15,1,2,133,FALSE,3273415,140399,10049607,3413814
2018-02-16,2,2,90,FALSE,3273415,140399,10049607,3413814
2018-02-17,3,2,83,FALSE,3273415,140399,10049607,3413814
2018-02-18,4,2,75,FALSE,3273415,140399,10049607,3413814
2018-02-14,0,3,90,FALSE,2775868,169305,10049607,2945173
2018-02-15,1,3,146,FALSE,2775868,169305,10049607,2945173
2018-02-16,2,3,85,FALSE,2775868,169305,10049607,2945173
2018-02-17,3,3,89,FALSE,2775868,169305,10049607,2945173
2018-02-18,4,3,91,FALSE,2775868,169305,10049607,2945173
2018-02-14,0,4,86,FALSE,3537015,235998,10049607,3773013
2018-02-15,1,4,138,FALSE,3537015,235998,10049607,3773013
2018-02-16,2,4,82,FALSE,3537015,235998,10049607,3773013
2018-02-17,3,4,82,FALSE,3537015,235998,10049607,3773013
2018-02-18,4,4,87,FALSE,3537015,235998,10049607,3773013
2018-02-14,0,5,86,FALSE,8292764,412067,10049607,8704831
2018-02-15,1,5,131,FALSE,8292764,412067,10049607,8704831
2018-02-16,2,5,85,FALSE,8292764,412067,10049607,8704831
2018-02-17,3,5,82,FALSE,8292764,412067,10049607,8704831
2018-02-18,4,5,85,FALSE,8292764,412067,10049607,8704831
2018-02-14,0,6,86,FALSE,17001816,817768,10049607,17819584
2018-02-15,1,6,143,FALSE,17001816,817768,10049607,17819584
2018-02-16,2,6,101,FALSE,17001816,817768,10049607,17819584
2018-02-17,3,6,86,FALSE,17001816,817768,10049607,17819584
2018-02-18,4,6,84,FALSE,17001816,817768,10049607,17819584
2018-02-14,0,7,83,FALSE,24459411,1107406,10049607,25566817
2018-02-15,1,7,163,FALSE,24459411,1107406,10049607,25566817
2018-02-16,2,7,92,FALSE,24459411,1107406,10049607,25566817
2018-02-17,3,7,79,FALSE,24459411,1107406,10049607,25566817
2018-02-18,4,7,82,FALSE,24459411,1107406,10049607,25566817
2018-02-14,0,8,85,FALSE,28017544,1182955,10049607,29200499
2018-02-15,1,8,145,FALSE,28017544,1182955,10049607,29200499
2018-02-16,2,8,94,FALSE,28017544,1182955,10049607,29200499
2018-02-17,3,8,80,FALSE,28017544,1182955,10049607,29200499
2018-02-18,4,8,80,FALSE,28017544,1182955,10049607,29200499
2018-02-14,0,9,87,FALSE,29724164,1366652,10049607,31090816
2018-02-15,1,9,156,FALSE,29724164,1366652,10049607,31090816
2018-02-16,2,9,97,FALSE,29724164,1366652,10049607,31090816
2018-02-17,3,9,81,FALSE,29724164,1366652,10049607,31090816
2018-02-18,4,9,80,FALSE,29724164,1366652,10049607,31090816
2018-02-14,0,10,87,FALSE,32506050,1375977,10049607,33882027
2018-02-15,1,10,166,FALSE,32506050,1375977,10049607,33882027
2018-02-16,2,10,95,FALSE,32506050,1375977,10049607,33882027
2018-02-17,3,10,84,FALSE,32506050,1375977,10049607,33882027
2018-02-18,4,10,80,FALSE,32506050,1375977,10049607,33882027
2018-02-14,0,11,91,FALSE,33167063,1277498,10049607,34444561
2018-02-15,1,11,191,FALSE,33167063,1277498,10049607,34444561
2018-02-16,2,11,98,FALSE,33167063,1277498,10049607,34444561
2018-02-17,3,11,83,FALSE,33167063,1277498,10049607,34444561
2018-02-18,4,11,81,FALSE,33167063,1277498,10049607,34444561
2018-02-14,0,12,103,FALSE,32117148,1137148,10049607,33254296
2018-02-15,1,12,205,FALSE,32117148,1137148,10049607,33254296
2018-02-16,2,12,107,FALSE,32117148,1137148,10049607,33254296
2018-02-17,3,12,88,FALSE,32117148,1137148,10049607,33254296
2018-02-18,4,12,81,FALSE,32117148,1137148,10049607,33254296
2018-02-14,0,13,103,FALSE,33997481,1166236,10049607,35163717
2018-02-15,1,13,187,FALSE,33997481,1166236,10049607,35163717
2018-02-16,2,13,109,FALSE,33997481,1166236,10049607,35163717
2018-02-17,3,13,89,FALSE,33997481,1166236,10049607,35163717
2018-02-18,4,13,87,FALSE,33997481,1166236,10049607,35163717
2018-02-14,0,14,118,FALSE,35343111,1211304,10049607,36554415
2018-02-15,1,14,191,FALSE,35343111,1211304,10049607,36554415
2018-02-16,2,14,129,FALSE,35343111,1211304,10049607,36554415
2018-02-17,3,14,92,FALSE,35343111,1211304,10049607,36554415
2018-02-18,4,14,91,FALSE,35343111,1211304,10049607,36554415
2018-02-14,0,15,119,FALSE,36331689,1163301,10049607,37494990
2018-02-15,1,15,181,FALSE,36331689,1163301,10049607,37494990
2018-02-16,2,15,134,FALSE,36331689,1163301,10049607,37494990
2018-02-17,3,15,93,FALSE,36331689,1163301,10049607,37494990
2018-02-18,4,15,89,FALSE,36331689,1163301,10049607,37494990
2018-02-14,0,16,131,FALSE,37837026,1078693,10049607,38915719
2018-02-15,1,16,169,FALSE,37837026,1078693,10049607,38915719
2018-02-16,2,16,147,FALSE,37837026,1078693,10049607,38915719
2018-02-17,3,16,95,FALSE,37837026,1078693,10049607,38915719
2018-02-18,4,16,88,FALSE,37837026,1078693,10049607,38915719
2018-02-14,0,17,145,FALSE,39453129,926338,10049607,40379467
2018-02-15,1,17,160,FALSE,39453129,926338,10049607,40379467
2018-02-16,2,17,155,FALSE,39453129,926338,10049607,40379467
2018-02-17,3,17,96,FALSE,39453129,926338,10049607,40379467
2018-02-18,4,17,88,FALSE,39453129,926338,10049607,40379467
2018-02-14,0,18,158,FALSE,35502334,641025,10049607,36143359
2018-02-15,1,18,148,FALSE,35502334,641025,10049607,36143359
2018-02-16,2,18,154,FALSE,35502334,641025,10049607,36143359
2018-02-17,3,18,92,FALSE,35502334,641025,10049607,36143359
2018-02-18,4,18,90,FALSE,35502334,641025,10049607,36143359
2018-02-14,0,19,170,FALSE,27464139,444594,10049607,27908733
2018-02-15,1,19,133,FALSE,27464139,444594,10049607,27908733
2018-02-16,2,19,148,FALSE,27464139,444594,10049607,27908733
2018-02-17,3,19,91,FALSE,27464139,444594,10049607,27908733
2018-02-18,4,19,90,FALSE,27464139,444594,10049607,27908733
2018-02-14,0,20,160,FALSE,21934682,315001,10049607,22249683
2018-02-15,1,20,120,FALSE,21934682,315001,10049607,22249683
2018-02-16,2,20,133,FALSE,21934682,315001,10049607,22249683
2018-02-17,3,20,88,FALSE,21934682,315001,10049607,22249683
2018-02-18,4,20,91,FALSE,21934682,315001,10049607,22249683
2018-02-14,0,21,177,FALSE,18329687,225653,10049607,18555340
2018-02-15,1,21,112,FALSE,18329687,225653,10049607,18555340
2018-02-16,2,21,119,FALSE,18329687,225653,10049607,18555340
2018-02-17,3,21,85,FALSE,18329687,225653,10049607,18555340
2018-02-18,4,21,90,FALSE,18329687,225653,10049607,18555340
2018-02-14,0,22,176,FALSE,14089466,174290,10049607,14263756
2018-02-15,1,22,104,FALSE,14089466,174290,10049607,14263756
2018-02-16,2,22,111,FALSE,14089466,174290,10049607,14263756
2018-02-17,3,22,88,FALSE,14089466,174290,10049607,14263756
2018-02-18,4,22,88,FALSE,14089466,174290,10049607,14263756
2018-02-14,0,23,168,FALSE,9906563,153019,10049607,10059582
2018-02-15,1,23,99,FALSE,9906563,153019,10049607,10059582
2018-02-16,2,23,102,FALSE,9906563,153019,10049607,10059582
2018-02-17,3,23,84,FALSE,9906563,153019,10049607,10059582
2018-02-18,4,23,87,FALSE,9906563,153019,10049607,10059582
2019-02-01,0,0,78,FALSE,6082397,116999,10010983,6199396
2019-02-02,1,0,84,TRUE,6082397,116999,10010983,6199396
2019-02-05,2,0,95,FALSE,6082397,116999,10010983,6199396
2019-02-06,3,0,80,FALSE,6082397,116999,10010983,6199396
2019-02-07,4,0,81,FALSE,6082397,116999,10010983,6199396
2019-02-01,0,1,82,FALSE,4105876,113501,10010983,4219377
2019-02-02,1,1,84,TRUE,4105876,113501,10010983,4219377
2019-02-05,2,1,91,FALSE,4105876,113501,10010983,4219377
2019-02-06,3,1,79,FALSE,4105876,113501,10010983,4219377
2019-02-07,4,1,80,FALSE,4105876,113501,10010983,4219377
2019-02-01,0,2,75,FALSE,2992139,120359,10010983,3112498
2019-02-02,1,2,84,TRUE,2992139,120359,10010983,3112498
2019-02-05,2,2,83,FALSE,2992139,120359,10010983,3112498
2019-02-06,3,2,81,FALSE,2992139,120359,10010983,3112498
2019-02-07,4,2,83,FALSE,2992139,120359,10010983,3112498
2019-02-01,0,3,82,FALSE,2580075,148734,10010983,2728809
2019-02-02,1,3,82,TRUE,2580075,148734,10010983,2728809
2019-02-05,2,3,79,FALSE,2580075,148734,10010983,2728809
2019-02-06,3,3,78,FALSE,2580075,148734,10010983,2728809
2019-02-07,4,3,84,FALSE,2580075,148734,10010983,2728809
2019-02-01,0,4,87,FALSE,3312988,207263,10010983,3520251
2019-02-02,1,4,87,TRUE,3312988,207263,10010983,3520251
2019-02-05,2,4,79,FALSE,3312988,207263,10010983,3520251
2019-02-06,3,4,96,FALSE,3312988,207263,10010983,3520251
2019-02-07,4,4,85,FALSE,3312988,207263,10010983,3520251
2019-02-01,0,5,89,FALSE,7744284,364551,10010983,8108835
2019-02-02,1,5,97,TRUE,7744284,364551,10010983,8108835
2019-02-05,2,5,79,FALSE,7744284,364551,10010983,8108835
2019-02-06,3,5,73,FALSE,7744284,364551,10010983,8108835
2019-02-07,4,5,87,FALSE,7744284,364551,10010983,8108835
2019-02-01,0,6,89,FALSE,15609418,732765,10010983,16342183
2019-02-02,1,6,93,TRUE,15609418,732765,10010983,16342183
2019-02-05,2,6,85,FALSE,15609418,732765,10010983,16342183
2019-02-06,3,6,78,FALSE,15609418,732765,10010983,16342183
2019-02-07,4,6,77,TRUE,15609418,732765,10010983,16342183
2019-02-01,0,7,84,FALSE,22516754,992031,10010983,23508785
2019-02-02,1,7,97,TRUE,22516754,992031,10010983,23508785
2019-02-05,2,7,90,FALSE,22516754,992031,10010983,23508785
2019-02-06,3,7,78,FALSE,22516754,992031,10010983,23508785
2019-02-07,4,7,88,FALSE,22516754,992031,10010983,23508785
2019-02-01,0,8,85,FALSE,26069293,1052916,10010983,27122209
2019-02-02,1,8,102,TRUE,26069293,1052916,10010983,27122209
2019-02-05,2,8,90,FALSE,26069293,1052916,10010983,27122209
2019-02-06,3,8,77,FALSE,26069293,1052916,10010983,27122209
2019-02-07,4,8,89,FALSE,26069293,1052916,10010983,27122209
2019-02-01,0,9,86,FALSE,27683552,1217778,10010983,28901330
2019-02-02,1,9,104,TRUE,27683552,1217778,10010983,28901330
2019-02-05,2,9,93,FALSE,27683552,1217778,10010983,28901330
2019-02-06,3,9,80,FALSE,27683552,1217778,10010983,28901330
2019-02-07,4,9,88,FALSE,27683552,1217778,10010983,28901330
2019-02-01,0,10,84,FALSE,30109333,1217018,10010983,31326351
2019-02-02,1,10,108,TRUE,30109333,1217018,10010983,31326351
2019-02-05,2,10,93,FALSE,30109333,1217018,10010983,31326351
2019-02-06,3,10,81,FALSE,30109333,1217018,10010983,31326351
2019-02-07,4,10,86,FALSE,30109333,1217018,10010983,31326351
2019-02-01,0,11,86,FALSE,30635851,1120010,10010983,31755861
2019-02-02,1,11,112,FALSE,30635851,1120010,10010983,31755861
2019-02-05,2,11,96,FALSE,30635851,1120010,10010983,31755861
2019-02-06,3,11,81,FALSE,30635851,1120010,10010983,31755861
2019-02-07,4,11,90,FALSE,30635851,1120010,10010983,31755861
2019-02-01,0,12,85,FALSE,29780696,993339,10010983,30774035
2019-02-02,1,12,105,FALSE,29780696,993339,10010983,30774035
2019-02-05,2,12,109,FALSE,29780696,993339,10010983,30774035
2019-02-06,3,12,82,FALSE,29780696,993339,10010983,30774035
2019-02-07,4,12,91,FALSE,29780696,993339,10010983,30774035
2019-02-01,0,13,122,FALSE,31582905,1031467,10010983,32614372
2019-02-02,1,13,106,FALSE,31582905,1031467,10010983,32614372
2019-02-05,2,13,118,FALSE,31582905,1031467,10010983,32614372
2019-02-06,3,13,86,FALSE,31582905,1031467,10010983,32614372
2019-02-07,4,13,92,FALSE,31582905,1031467,10010983,32614372
2019-02-01,0,14,94,FALSE,32710451,1071974,10010983,33782425
2019-02-02,1,14,116,FALSE,32710451,1071974,10010983,33782425
2019-02-05,2,14,125,FALSE,32710451,1071974,10010983,33782425
2019-02-06,3,14,90,FALSE,32710451,1071974,10010983,33782425
2019-02-07,4,14,90,FALSE,32710451,1071974,10010983,33782425
2019-02-01,0,15,91,FALSE,33608944,1024221,10010983,34633165
2019-02-02,1,15,107,FALSE,33608944,1024221,10010983,34633165
2019-02-05,2,15,116,FALSE,33608944,1024221,10010983,34633165
2019-02-06,3,15,93,FALSE,33608944,1024221,10010983,34633165
2019-02-07,4,15,84,FALSE,33608944,1024221,10010983,34633165
2019-02-01,0,16,93,FALSE,35032825,955431,10010983,35988256
2019-02-02,1,16,105,FALSE,35032825,955431,10010983,35988256
2019-02-05,2,16,136,FALSE,35032825,955431,10010983,35988256
2019-02-06,3,16,95,FALSE,35032825,955431,10010983,35988256
2019-02-07,4,16,84,FALSE,35032825,955431,10010983,35988256
2019-02-01,0,17,102,FALSE,36516571,806893,10010983,37323464
2019-02-02,1,17,112,FALSE,36516571,806893,10010983,37323464
2019-02-05,2,17,141,FALSE,36516571,806893,10010983,37323464
2019-02-06,3,17,98,FALSE,36516571,806893,10010983,37323464
2019-02-07,4,17,86,FALSE,36516571,806893,10010983,37323464
2019-02-01,0,18,114,FALSE,32785624,744287,10010983,33529911
2019-02-02,1,18,103,FALSE,32785624,744287,10010983,33529911
2019-02-05,2,18,140,FALSE,32785624,744287,10010983,33529911
2019-02-06,3,18,96,FALSE,32785624,744287,10010983,33529911
2019-02-07,4,18,88,FALSE,32785624,744287,10010983,33529911
2019-02-01,0,19,118,TRUE,24920431,387278,10010983,25307709
2019-02-02,1,19,108,FALSE,24920431,387278,10010983,25307709
2019-02-05,2,19,131,FALSE,24920431,387278,10010983,25307709
2019-02-06,3,19,93,FALSE,24920431,387278,10010983,25307709
2019-02-07,4,19,87,FALSE,24920431,387278,10010983,25307709
2019-02-01,0,20,114,TRUE,19848460,268311,10010983,20116771
2019-02-02,1,20,95,FALSE,19848460,268311,10010983,20116771
2019-02-05,2,20,121,FALSE,19848460,268311,10010983,20116771
2019-02-06,3,20,91,FALSE,19848460,268311,10010983,20116771
2019-02-07,4,20,87,FALSE,19848460,268311,10010983,20116771
2019-02-01,0,21,105,TRUE,16589408,193720,10010983,16783128
2019-02-02,1,21,92,FALSE,16589408,193720,10010983,16783128
2019-02-05,2,21,112,FALSE,16589408,193720,10010983,16783128
2019-02-06,3,21,92,FALSE,16589408,193720,10010983,16783128
2019-02-07,4,21,83,FALSE,16589408,193720,10010983,16783128
2019-02-01,0,22,103,TRUE,12752880,148790,10010983,12901670
2019-02-02,1,22,94,FALSE,12752880,148790,10010983,12901670
2019-02-05,2,22,103,FALSE,12752880,148790,10010983,12901670
2019-02-06,3,22,90,FALSE,12752880,148790,10010983,12901670
2019-02-07,4,22,85,FALSE,12752880,148790,10010983,12901670
2019-02-01,0,23,102,TRUE,8879652,125583,10010983,9005235
2019-02-02,1,23,91,FALSE,8879652,125583,10010983,9005235
2019-02-05,2,23,97,FALSE,8879652,125583,10010983,9005235
2019-02-06,3,23,87,FALSE,8879652,125583,10010983,9005235
2019-02-07,4,23,82,FALSE,8879652,125583,10010983,9005235
2020-01-23,0,0,77,FALSE,20148323,1190856,9911088,21339179
2020-01-24,1,0,121,FALSE,20148323,1190856,9911088,21339179
2020-01-25,2,0,86,FALSE,20148323,1190856,9911088,21339179
2020-01-26,3,0,94,FALSE,20148323,1190856,9911088,21339179
2020-01-27,4,0,80,FALSE,20148323,1190856,9911088,21339179
2020-01-23,0,1,79,FALSE,12130362,987272,9911088,13117634
2020-01-24,1,1,125,FALSE,12130362,987272,9911088,13117634
2020-01-25,2,1,89,FALSE,12130362,987272,9911088,13117634
2020-01-26,3,1,92,FALSE,12130362,987272,9911088,13117634
2020-01-27,4,1,79,FALSE,12130362,987272,9911088,13117634
2020-01-23,0,2,79,FALSE,8824785,1106470,9911088,9931255
2020-01-24,1,2,139,FALSE,8824785,1106470,9911088,9931255
2020-01-25,2,2,89,FALSE,8824785,1106470,9911088,9931255
2020-01-26,3,2,88,FALSE,8824785,1106470,9911088,9931255
2020-01-27,4,2,99,FALSE,8824785,1106470,9911088,9931255
2020-01-23,0,3,87,FALSE,8199982,1315501,9911088,9515483
2020-01-24,1,3,143,FALSE,8199982,1315501,9911088,9515483
2020-01-25,2,3,93,FALSE,8199982,1315501,9911088,9515483
2020-01-26,3,3,91,FALSE,8199982,1315501,9911088,9515483
2020-01-27,4,3,84,FALSE,8199982,1315501,9911088,9515483
2020-01-23,0,4,87,FALSE,12731122,1698899,9911088,14430021
2020-01-24,1,4,131,FALSE,12731122,1698899,9911088,14430021
2020-01-25,2,4,86,FALSE,12731122,1698899,9911088,14430021
2020-01-26,3,4,88,FALSE,12731122,1698899,9911088,14430021
2020-01-27,4,4,82,FALSE,12731122,1698899,9911088,14430021
2020-01-23,0,5,89,FALSE,38557193,2564767,9911088,41121960
2020-01-24,1,5,147,FALSE,38557193,2564767,9911088,41121960
2020-01-25,2,5,89,FALSE,38557193,2564767,9911088,41121960
2020-01-26,3,5,82,FALSE,38557193,2564767,9911088,41121960
2020-01-27,4,5,83,FALSE,38557193,2564767,9911088,41121960
2020-01-23,0,6,89,FALSE,80475471,3807967,9911088,84283438
2020-01-24,1,6,153,FALSE,80475471,3807967,9911088,84283438
2020-01-25,2,6,91,FALSE,80475471,3807967,9911088,84283438
2020-01-26,3,6,82,FALSE,80475471,3807967,9911088,84283438
2020-01-27,4,6,78,FALSE,80475471,3807967,9911088,84283438
2020-01-23,0,7,88,FALSE,120952590,4272388,9911088,125224978
2020-01-24,1,7,155,FALSE,120952590,4272388,9911088,125224978
2020-01-25,2,7,93,FALSE,120952590,4272388,9911088,125224978
2020-01-26,3,7,89,FALSE,120952590,4272388,9911088,125224978
2020-01-27,4,7,80,FALSE,120952590,4272388,9911088,125224978
2020-01-23,0,8,93,FALSE,129436532,4526928,9911088,133963460
2020-01-24,1,8,150,FALSE,129436532,4526928,9911088,133963460
2020-01-25,2,8,99,FALSE,129436532,4526928,9911088,133963460
2020-01-26,3,8,83,FALSE,129436532,4526928,9911088,133963460
2020-01-27,4,8,84,FALSE,129436532,4526928,9911088,133963460
2020-01-23,0,9,97,FALSE,119768600,5104871,9911088,124873471
2020-01-24,1,9,159,FALSE,119768600,5104871,9911088,124873471
2020-01-25,2,9,94,FALSE,119768600,5104871,9911088,124873471
2020-01-26,3,9,87,FALSE,119768600,5104871,9911088,124873471
2020-01-27,4,9,79,FALSE,119768600,5104871,9911088,124873471
2020-01-23,0,10,93,FALSE,127662301,4891865,9911088,132554166
2020-01-24,1,10,177,FALSE,127662301,4891865,9911088,132554166
2020-01-25,2,10,94,FALSE,127662301,4891865,9911088,132554166
2020-01-26,3,10,85,FALSE,127662301,4891865,9911088,132554166
2020-01-27,4,10,81,FALSE,127662301,4891865,9911088,132554166
2020-01-23,0,11,94,FALSE,129653213,4524882,9911088,134178095
2020-01-24,1,11,188,FALSE,129653213,4524882,9911088,134178095
2020-01-25,2,11,102,FALSE,129653213,4524882,9911088,134178095
2020-01-26,3,11,83,FALSE,129653213,4524882,9911088,134178095
2020-01-27,4,11,84,FALSE,129653213,4524882,9911088,134178095
2020-01-23,0,12,104,FALSE,125981832,4059192,9911088,130041024
2020-01-24,1,12,194,FALSE,125981832,4059192,9911088,130041024
2020-01-25,2,12,112,FALSE,125981832,4059192,9911088,130041024
2020-01-26,3,12,89,FALSE,125981832,4059192,9911088,130041024
2020-01-27,4,12,85,FALSE,125981832,4059192,9911088,130041024
2020-01-23,0,13,106,FALSE,134698380,4028851,9911088,138727231
2020-01-24,1,13,196,FALSE,134698380,4028851,9911088,138727231
2020-01-25,2,13,111,FALSE,134698380,4028851,9911088,138727231
2020-01-26,3,13,93,FALSE,134698380,4028851,9911088,138727231
2020-01-27,4,13,86,FALSE,134698380,4028851,9911088,138727231
2020-01-23,0,14,115,FALSE,140216936,4098335,9911088,144315271
2020-01-24,1,14,172,FALSE,140216936,4098335,9911088,144315271
2020-01-25,2,14,127,FALSE,140216936,4098335,9911088,144315271
2020-01-26,3,14,96,FALSE,140216936,4098335,9911088,144315271
2020-01-27,4,14,87,FALSE,140216936,4098335,9911088,144315271
2020-01-23,0,15,121,FALSE,143690520,3843105,9911088,147533625
2020-01-24,1,15,170,FALSE,143690520,3843105,9911088,147533625
2020-01-25,2,15,127,FALSE,143690520,3843105,9911088,147533625
2020-01-26,3,15,98,FALSE,143690520,3843105,9911088,147533625
2020-01-27,4,15,91,FALSE,143690520,3843105,9911088,147533625
2020-01-23,0,16,129,FALSE,150525075,3439283,9911088,153964358
2020-01-24,1,16,153,FALSE,150525075,3439283,9911088,153964358
2020-01-25,2,16,145,FALSE,150525075,3439283,9911088,153964358
2020-01-26,3,16,99,FALSE,150525075,3439283,9911088,153964358
2020-01-27,4,16,86,FALSE,150525075,3439283,9911088,153964358
2020-01-23,0,17,149,FALSE,159476871,2846161,9911088,162323032
2020-01-24,1,17,142,FALSE,159476871,2846161,9911088,162323032
2020-01-25,2,17,139,FALSE,159476871,2846161,9911088,162323032
2020-01-26,3,17,100,FALSE,159476871,2846161,9911088,162323032
2020-01-27,4,17,92,FALSE,159476871,2846161,9911088,162323032
2020-01-23,0,18,153,FALSE,145540868,2131362,9911088,147672230
2020-01-24,1,18,130,FALSE,145540868,2131362,9911088,147672230
2020-01-25,2,18,152,FALSE,145540868,2131362,9911088,147672230
2020-01-26,3,18,98,FALSE,145540868,2131362,9911088,147672230
2020-01-27,4,18,94,FALSE,145540868,2131362,9911088,147672230
2020-01-23,0,19,162,FALSE,107548314,1693821,9911088,109242135
2020-01-24,1,19,117,FALSE,107548314,1693821,9911088,109242135
2020-01-25,2,19,147,FALSE,107548314,1693821,9911088,109242135
2020-01-26,3,19,97,FALSE,107548314,1693821,9911088,109242135
2020-01-27,4,19,89,FALSE,107548314,1693821,9911088,109242135
2020-01-23,0,20,180,FALSE,85398817,1303605,9911088,86702422
2020-01-24,1,20,108,FALSE,85398817,1303605,9911088,86702422
2020-01-25,2,20,132,FALSE,85398817,1303605,9911088,86702422
2020-01-26,3,20,93,FALSE,85398817,1303605,9911088,86702422
2020-01-27,4,20,94,FALSE,85398817,1303605,9911088,86702422
2020-01-23,0,21,195,FALSE,68703818,1074256,9911088,69778074
2020-01-24,1,21,102,FALSE,68703818,1074256,9911088,69778074
2020-01-25,2,21,118,FALSE,68703818,1074256,9911088,69778074
2020-01-26,3,21,89,FALSE,68703818,1074256,9911088,69778074
2020-01-27,4,21,95,FALSE,68703818,1074256,9911088,69778074
2020-01-23,0,22,167,FALSE,48472139,919533,9911088,49391672
2020-01-24,1,22,97,FALSE,48472139,919533,9911088,49391672
2020-01-25,2,22,108,FALSE,48472139,919533,9911088,49391672
2020-01-26,3,22,87,FALSE,48472139,919533,9911088,49391672
2020-01-27,4,22,97,FALSE,48472139,919533,9911088,49391672
2020-01-23,0,23,179,FALSE,30762106,903098,9911088,31665204
2020-01-24,1,23,90,FALSE,30762106,903098,9911088,31665204
2020-01-25,2,23,102,FALSE,30762106,903098,9911088,31665204
2020-01-26,3,23,89,FALSE,30762106,903098,9911088,31665204
2020-01-27,4,23,94,FALSE,30762106,903098,9911088,31665204
